111111
100001
101C01
101001
101E01
111111
