111111
1C0001
101101
100P01
101E01
111111
