11111111111
1C00C000001
1C110000001
1C0P0000001
101E0000001
11111111111
