11111111111111111111111111111
1C00C000000000000000000000001
1C110000000000000000000000001
1C0P0000000000000000000000001
101E000000000000000C000000001
10000000000000000000000000001
10000000000000000C00000000001
11111111111111111111111111111
